#######################################
# Syntax Coloring Map For ArduinoBLE
#######################################

#######################################
# Datatypes (KEYWORD1)
#######################################

ArduinoBLE	KEYWORD1
BLE	KEYWORD1

BLE	KEYWORD1
BLECharacteristic	KEYWORD1
BLEDescriptor	KEYWORD1
BLEService	KEYWORD1

BLEBoolCharacteristic	KEYWORD1
BLEBooleanCharacteristic	KEYWORD1
BLECharCharacteristic	KEYWORD1
BLEUnsignedCharCharacteristic	KEYWORD1
BLEByteCharacteristic	KEYWORD1
BLEShortCharacteristic	KEYWORD1
BLEUnsignedShortCharacteristic	KEYWORD1
BLEWordCharacteristic	KEYWORD1
BLEIntCharacteristic	KEYWORD1
BLEUnsignedIntCharacteristic	KEYWORD1
BLELongCharacteristic	KEYWORD1
BLEUnsignedLongCharacteristic	KEYWORD1
BLEFloatCharacteristic	KEYWORD1
BLEDoubleCharacteristic	KEYWORD1
BLEStringCharacteristic	KEYWORD1

#######################################
# Methods and Functions (KEYWORD2)
#######################################

begin	KEYWORD2
poll	KEYWORD2
end	KEYWORD2

connected	KEYWORD2
disconnect	KEYWORD2
address	KEYWORD2
rssi	KEYWORD2

setAdvertisedServiceUuid	KEYWORD2
setManufacturerData	KEYWORD2
setLocalName	KEYWORD2
setDeviceName	KEYWORD2
setAppearance	KEYWORD2
addService	KEYWORD2
advertise	KEYWORD2
stopAdvertise	KEYWORD2
central	KEYWORD2
setEventHandler	KEYWORD2
setAdvertisingInterval	KEYWORD2
setConnectionInterval	KEYWORD2
setConnectable	KEYWORD2
debug	KEYWORD2
noDebug	KEYWORD2

properties	KEYWORD2
valueSize	KEYWORD2
value	KEYWORD2
valueLength	KEYWORD2
writeValue	KEYWORD2
setValue	KEYWORD2
broadcast	KEYWORD2
written	KEYWORD2
subscribed	KEYWORD2
addDescriptor	KEYWORD2
writeValueLE	KEYWORD2
setValueLE	KEYWORD2
valueLE	KEYWORD2
writeValueBE	KEYWORD2
setValueBE	KEYWORD2
valueBE	KEYWORD2

uuid	KEYWORD2
addCharacteristic	KEYWORD

#######################################
# Constants (LITERAL1)
#######################################

BLEBroadcast	LITERAL1
BLERead	LITERAL1
BLEWriteWithoutResponse	LITERAL1
BLEWrite	LITERAL1
BLENotify	LITERAL1
BLEIndicate	LITERAL1

BLESubscribed	LITERAL1
BLEUnsubscribed	LITERAL1
BLEWritten	LITERAL1

